//
//0 brick
//1 brick wall top
//2 floor
//3 brick wall bottom
//4 gray-light wall all-around
//5 gray-light wall bottom, left, top
//6 ...there are more
//
// double slashes (comment characters) are not read
// 
// DIRECTIONS: run this file through the script and it will make it useable
// in the game engine. CURRENTLY ONLY SINGLE DIGIT IDs - this will change when needed
//
0000000000000000000000000000
0033333333333333333333333300
0022222222222222222222222200
0022222222222222222222222200
0022222222222222222222222200
0022666266626222666222222200
0022622262626222622222222200
0022622262626222666222222200
0022622262626222622222222200
0022666266626662666222222200
0055555552222222225555555500
0022222252222222225222222200
0022222252222222225222222200
0022222252222222225222222200
0022222222222222222222222200
0022222252222222222222222200
0055555552222222225555555500
0022222222222222222222222200
0022222222222222222222222200
0022222222222222222222222200
0011111111111111111111111100
0000000000000000000000000000