00000000000000000000000000000000000000000000000000
00000000000000000000000000000000000000000000000000
00011111111111111111111111111111111111111111111100
00111111111111111111111111111111111111111111111100
00111111111111111111111111111111111111111111111100
00111100111111111111111111111000100010111000111100
00111111111110011111111111111011101010111001111100
00111111111111111111111101111000100010001000111100
00111111111111111111111001111111111111111111111100
00111111111111111110000001111111111111111111111100
00111111111111111111111111111111111111111111111100
00111111111111111111111111111111111111111111111100
00111111111111111111000001111111111111111111111100
00111011111111111111111111111111111111111111111100
00111111111111111111111111111111111111111111111100
00111111111111111111111111111111111111111111111100
00111111111111111111111111111111111111111111111100
00111111111111111111111111111111111111111111111100
00111111111111111111111111111111111111111111111100
00111111111111111111111111111111111111111111111100
00111111111111111110101011111111111111111111111100
00111111111111111110101011111111111111111111111100
00111111111111111110001011111111111111111111111100
00111111111111111110101011111111111111111111111100
00111111111111111110101011111111111111111111111100
00111111111111111111111111111111111111111111111100
00111111111111111111111111111111111111111111111100
00111111111111111111111111111111111111111111111100
00111111111111111111111111111111111111111111111100
00000000000000000000000000000000000000000000000000
00000000000000000000000000000000000000000000000000
