0/0/0/0/0/0/0/0/0/0/0/0/0/0/0/0/0/0/0/0/0/0/0/0/0/0/0/0/
0/0/3/3/3/3/3/3/3/3/3/3/3/3/3/3/3/3/3/3/3/3/3/3/3/3/0/0/
0/0/2/2/2/2/2/2/2/2/2/2/2/2/2/2/2/2/2/2/2/2/2/2/2/2/0/0/
0/0/2/2/2/2/2/2/2/2/2/2/2/2/2/2/2/2/2/2/2/2/2/2/2/2/0/0/
0/0/2/2/2/2/2/2/2/2/2/2/2/2/2/2/2/2/2/2/2/2/2/2/2/2/0/0/
0/0/2/2/6/6/6/2/6/6/6/2/6/2/2/2/6/6/6/2/2/2/2/2/2/2/0/0/
0/0/2/2/6/2/2/2/6/2/6/2/6/2/2/2/6/2/2/2/2/2/2/2/2/2/0/0/
0/0/2/2/6/2/2/2/6/2/6/2/6/2/2/2/6/6/6/2/2/2/2/2/2/2/0/0/
0/0/2/2/6/2/2/2/6/2/6/2/6/2/2/2/6/2/2/2/2/2/2/2/2/2/0/0/
0/0/2/2/6/6/6/2/6/6/6/2/6/6/6/2/6/6/6/2/2/2/2/2/2/2/0/0/
0/0/2/2/2/2/2/2/2/2/2/2/2/2/2/2/2/2/2/2/2/2/2/2/2/2/0/0/
0/0/2/2/2/2/2/2/2/2/2/2/2/2/2/2/2/2/2/2/2/2/2/2/2/2/0/0/
0/0/5/5/5/5/5/5/5/2/2/2/2/2/2/2/2/2/5/5/5/5/5/5/5/5/0/0/
0/0/2/2/2/2/2/2/5/2/2/2/2/2/2/2/2/2/5/2/2/2/2/2/2/2/0/0/
0/0/2/2/2/2/2/2/5/2/2/2/2/2/2/2/2/2/5/2/2/2/2/2/2/2/0/0/
0/0/2/2/2/2/2/2/5/2/2/2/2/2/2/2/2/2/5/2/2/2/2/2/2/2/0/0/
0/0/2/2/2/2/2/2/2/2/2/2/2/2/2/2/2/2/2/2/2/2/2/2/2/2/0/0/
0/0/2/2/2/2/2/2/5/2/2/2/2/2/2/2/2/2/2/2/2/2/2/2/2/2/0/0/
0/0/5/5/5/5/5/5/5/2/2/2/2/2/2/2/2/2/5/5/5/5/5/5/5/5/0/0/
0/0/2/2/2/2/2/2/2/2/2/2/2/2/2/2/2/2/2/2/2/2/2/2/2/2/0/0/
0/0/2/2/2/2/2/2/2/2/2/2/2/2/2/2/2/2/2/2/2/2/2/2/2/2/0/0/
0/0/2/2/2/2/2/2/2/2/2/2/2/2/2/2/2/2/2/2/2/2/2/2/2/2/0/0/
0/0/2/2/2/2/2/2/2/2/2/2/2/2/2/2/2/2/2/2/2/2/2/2/2/2/0/0/
0/0/2/2/2/2/2/2/2/2/2/2/2/2/2/2/2/2/2/2/2/2/2/2/2/2/0/0/
0/0/1/1/1/1/1/1/1/1/1/1/1/1/1/1/1/1/1/1/1/1/1/1/1/1/0/0/
0/0/0/0/0/0/0/0/0/0/0/0/0/0/0/0/0/0/0/0/0/0/0/0/0/0/0/0/
*